WWWWWWWWWWWWWWWWWW
WH               W
WWWWWWWWWWWWWWWWKW
W                W
WDWWWWWWWWWWWWWWWW