WWWDWWWWWWW
WM CD     W
WMCMMMMM  W
WH KW     W
WWWWWDWWWWW